0,1,1,1,1,1,1,1,1,1,1,2
10,11,11,11,11,11,11,11,11,11,11,12
10,11,11,11,11,11,11,11,11,11,11,12
10,11,11,11,11,11,11,11,11,11,11,12
10,11,11,11,11,11,11,11,11,11,11,12
10,11,11,11,11,11,11,11,11,11,11,12
10,11,11,11,11,11,11,11,11,11,11,12
10,11,11,11,11,11,11,11,11,11,11,12
10,11,11,11,11,11,11,11,11,11,11,12
10,11,11,11,11,11,11,11,11,11,11,12
10,11,11,11,11,11,11,11,11,11,11,12
20,21,21,21,21,21,21,21,21,21,21,22
